10000000000000000000000000000000000000000000000000000000001
10000000000000111100000000000000000000000000000000000000000000001
10000000000000000000000000111100000000000000000000000000000000000001
10000000000000000000000000000000000000000000111100000000000001
10000000000000000000000000000000000000000000000000000000000111101
10001111000000000000000000000000000000000000000000000000000001
10000000000000000000000000000000000000000000000000000000000001
10111111111111111111111111111111111111111111111111111111111111111111
10000000000000000000000000000000000000000000000000000000000001
10000000000000000000000000000000000000000000000000000000001